AL|IS
CBS|スポーツ
CM|AC
CanCam|.jp
C|NBC
D|ICJ
D|e|N|A
Face|book
F|・|ロペス
Getty| |Images
G|7
G|・|ディミトロフ
Korey| |Stringer| |Institute
Low|ie| |v|a|n| |DE| |Ooyevaar
P|B|C
P|S|G
R|ソックス
R|・|ナダル
SE|SU
SPORT|.|e|s
TEN|ET
The| |North| |American| |Journal| |of| |Medical| |Science|s
Yahoo|!|ニュース
cinemacafe|.net
octane|.jp
tennis|3|6|5|.net
この|まち|メディア|Web
どう|しん|電子|版
ひら|まつ|病院
ふじ|の|くに|スポーツ|サポーター
アット|エス
アドリアーノ|・|ホー
アマゾン|・|ドット|・|コム
アンブレラ|スカイ|せん|ま|や
ウェスタン|フォース
ウクライナ|公共|放送|局
エー|リス
カンボジア|地雷|除去|センター
クリストファー|・|ノーラン
クロード|・|モネ
クープ|・|ドゥ|・|フランス
グスタフ|・|クリムト
コカ|・|コーラ
サン|さん|晴れ|の|めぐみ
サン|ドリン|ガム|・|ハウス
サンケイ|スポーツ
ジェームズ|・|キャメロン
ジミ|ー|・|バトラー
スタッド|・|ド|・|フランス
スター|・|ウォーズ
ステファニー|・|カフ
スーパー|ラグビー
セブン|―|イレブン|・|ジャパン
セブン|イレブン
タイラー|・|ヒーロー
ダンカン|・|ロビンソン
チャンピオンズ|リーグ
テレビ|朝日
デジタル|庁
デーリー|東北|新聞|社
トム|・|ライト
トロピカーナ|・|フィールド
ニュース|イッチ
ネイ|マール
バイオ|ジェン
バスケット|・|カウント
パリ|・|サンジェルマン
ビリャ|レアル
フェラーリ|・|モンディアル
フットボール|チャンネル
フル|ガル
ブラン|ビーズ
ブルー|ジェイズ
プライム|デー
プレイ|・|フロム|・|フク|シマ
ヘタ|フェ
ベースボール|キング
ボストン|・|レッド|ソックス
マカオ|カジノ|規制|当局
ミッチェル|・|ランゲ|ラック
ムチ|ュア|・| |マドリッド|・|オープン
メジャー|リーグ
メット|ライフ|ドーム
メヒカリ|ボーイズ
ライブ|ハウス
リーグ|・|アン
レアル|・|ソシエダード
レバンテ|フジ|静岡
ロイヤル|・|ファウンデーション
ロサンゼルス|・|ドジャース
ワーナー|・|ブラザース
ワールド|シリーズ
一|乗|谷|朝倉|氏|遺跡
中島|翔|哉
中森|俊介
乃木坂|4|6
久保|建|英
交通|政策|審議|会
伊勢|新聞
佐賀|新聞|LiVE
佐賀|新聞|ニュース
何|浩瀚
健康|ほっと|セミナー
全国|知事|会
共同|通信
共産|党
北國|新聞|社
北海道|・|三陸|沖|後発|地震
北海道|南西|沖|地震
北海道|新聞
医薬|品|医療|機器|総合|機構
南海|トラフ|地震
厚生|科学|審議|会
友|楽園
名古屋|刑務|所
和田|豊
唐山|翔|自
増田|敬太郎
増田|神社
大築|紅葉
大野|雄
宇部|日報
安田|尚憲
宮原|和也
宮川|哲
宮本|恒靖
富士|スピードウェイ
山下|美月
山口|俊
岡|大海
岩渕|健輔
川勝|平太
平野|星矢
新華|社
日本|医師|会
日本|海|中部|地震
日本|青年|会議|所
明石|商
昭和|電工|ドーム|大分
晴れ|の|めぐみ|岡山|ブランド
最高|裁判|所
朝日|光輝
木下|明夫
本田|圭佑
村上|建治|郎
村上|敬一
東|日本|大|震災
東スポ|Web
東京|五輪
東京|電力|福島|第|一|原発|事故
松井|証券
柳|賢|振
桑|水流
桑名|江場|店
森山|外|源
武田|良徳
気象|庁
法制|審議|会
法務|省
浜名|湖
海|湖|館
清水|周一
湯|涌
湯|涌|ぼんぼり祭り
湯|涌|温泉
源田|壮亮
現代|ビジネス
産経|新聞
田中|みな|実
田中みな|実
甲子|園
福岡|堅|樹
福島|民報
種市|篤|暉
立憲|民主|党
筒香|嘉|智
紺野|真之介
統一|ロシア
習|近平
花|咲く|いろは
菅原|利和
菅野|剛士
藤田|剛二
表|参道
観光|庁
鈴木|将平
鈴木|英敬
関東|大|震災
静岡|新聞
非常|事態|庁
飯沼|一|丈
高|串
鳥谷|敬
ＡＢＣ|テレビ
Ｄ|Ａ|Ｚ|Ｕ|－|Ｏ
Ｅ|Ｌ
Ｇ|大阪
Ｐｒａｙ| |ｆｒｏｍ| |Ｆｕｋｕｓｈｉｍａ
Ｒ|ソシエダード
Ｒ|マドリード
